0,0,b,0,0,0,0,0,0,0,0,0,0,b,0,0
0,0,b,0,0,0,0,0,2,0,0,0,0,b,0,0
0,0,b,0,0,0,0,0,c,c,0,0,0,b,0,0
0,0,b,0,0,0,0,0,0,0,0,0,0,b,0,0
0,0,b,5,0,0,0,0,0,0,0,0,0,b,0,0
0,0,b,c,c,c,c,c,0,0,0,0,0,b,0,0
0,0,b,0,0,0,0,0,0,0,0,0,0,b,0,0
0,0,b,0,0,0,0,0,4,0,0,0,0,b,0,0
0,0,b,0,0,0,0,0,c,c,c,c,0,b,0,0
0,0,b,0,0,0,0,0,0,0,0,0,0,b,0,0
0,0,b,10,0,0,0,0,0,0,0,0,0,b,0,0
a,a,a,a,a,a,a,a,a,a,a,a,a,a,a,a